==33333====
=336663====
=3666633===
=36666663==
=33666663==
==366663555
5553663=555
555=333=55=
=555555555=
=555555555=
===========
