00000000000
00000000000
00000000000
00001000000
00001000000
00001000000
00001100000
00000111100
00000000000
00000000000
00000000000
