==33333=22=
=336663=222
=3666633=22
=3666666322
=3366666322
==366663=22
===3663=222
=====33=222
====222222=
====222222=
====22=====
