66666666===
6666666====
66666======
666========
===========
===========
===========
666========
6666==666==
6666666666=
66666666666
