66666666===
6666600====
66666======
666====0=0=
==0=00000==
000000000==
0000000000=
666==000=00
6666==666=0
6666666666=
66666666666
